/aboutus.htm	/page/about-us
/boi2011.htm	/crawfish2011/index.html
/carbonblack.htm	/page/carbon-black
/cementcar.htm	/
/cementtruck.htm	/
/chlorine.htm	/page/acid-tank-car
/contactus.htm	/page/contact-us
/containers.htm	/page/intermodal-containers
/default.htm	/
/Default.htm	/
/gatxairslide.htm	/page/air-slide
/generalservice.htm	/page/general-purpose-tank-cars
/hcl.htm	/page/acid-tank-car
/liquidtruck.htm	/
/newsandevents.htm	/
/partners.htm	/page/channel-partners
/pellettrucking.htm	/
/phosphoric.htm	/page/acid-tank-car
/plasticresin.htm	/page/plastic-pellet--resin
/pressuredifferential.htm	/page/pressure-differential
/pressuretank.htm	/page/pressure-car
/products.htm	/
/sitemap.htm	/page/sitemap
/sulfuric.htm	/page/acid-tank-car
